15 15
111111111111111
100000100000001
101111101111111
100000000000101
111010111111101
100010001000101
111010111011101
100010000000001
101010111010111
101010001010101
101011101011101
101000100000001
111011111110101
100000000000101
111111111111111
